#################################################################################################################################
#################################################################################################################################
#################################################################################################################################
#################################################################################################################################
#################################################################################################################################
#####                                                         #####                                                         #####
#####     *                                                   #####                                                         #####
#####     *                                                   #####                                                         #####
#####                                                         #####                                                         #####
#####                                                         #####                                                         #####
#####                                                         #####                                                         #####
#####                                                         #####                                                         #####
#####                                                         #####                                                         #####
#####                                                         #####                                                         #####
#####                                                         #####                                                         #####
#####                                                         #####                                                         #####
#####                                                         #####                                                         #####
#####                                                         #####                                                         #####
#####                                                         #####                                                         #####
#####                                                         #####                                                         #####
#####                                                         #####                                                         #####
#####                                                         #####                                                         #####
#####                                                         #####                                                         #####
#####                                                         #####                                                         #####
#####                                                         #####                                                         #####
#####                                                         #####                                                         #####
#####                   #########################             #####             #########################                   #####
#####                   #########################             #####             #########################                   #####
#####                   #########################             #####             #########################                   #####
#####                   #########################             #####             #########################                   #####
#####                   #########################             #####             #########################                   #####
#####                                                         #####                                                         #####
#####                                                         #####                                                         #####
#####                                                                                                                       #####
#####                                                                                                                       #####
#####                                                                                                                       #####
#####                                                                                                                       #####
#####                                                                                                                       #####
#####                                                                                                                       #####
#####                                                                                                                       #####
#####                                                                                                                       #####
#####                                                                                                                       #####
#####                                                                                                                       #####
#####                                                                                                                       #####
#####                         #####                                                           #####                         #####
#####                         #####                                                           #####                         #####
#####                         #####                 #########################                 #####                         #####
#####                         #####                 #########################                 #####                         #####
#####                         #####                 #########################                 #####                         #####
#####                         #####                 #########################                 #####                         #####
#####                         #####                 #########################                 #####                         #####
#####                         #####                                                           #####                         #####
#####                         #####                                                           #####                         #####
#####                         #####                                                           #####                         #####
#####                         #####                                                           #####                         #####
#####                         #####                                                           #####                         #####
#####                         #####                                                           #####                         #####
#####                         #####                                                           #####                         #####
#####                         #####                                                           #####                         #####
#####                         #####                                                           #####                         #####
#####                         #####                                                           #####                         #####
#####                         #####                                                           #####                         #####
#################             #####                                                           #####             #################
#################             #####                                                           #####             #################
#################             #####                                                           #####             #################
#################             #####                                                           #####             #################
#################             #####                                                           #####             #################
#####                         #####                                                           #####                         #####
#####                         #####                                                           #####                         #####
#####                         #####                                                           #####                         #####
#####                         #####                                                           #####                         #####
#####                         #####                                                           #####                         #####
#####                         #####                                                           #####                         #####
#####                         #####                                                           #####                         #####
#####                         #####                                                           #####                         #####
#####                         #####                                                           #####                         #####
#####                         #####                                                           #####                         #####
#####                         #####                                                           #####                         #####
#####                         #####                 #########################                 #####                         #####
#####                         #####                 #########################                 #####                         #####
#####                         #####                 #########################                 #####                         #####
#####                         #####                 #########################                 #####                         #####
#####                         #####                 #########################                 #####                         #####
#####                         #####                                                           #####                         #####
#####                         #####                                                           #####                         #####
#####                                                                                                                       #####
#####                                                                                                                       #####
#####                                                                                                                       #####
#####                                                                                                                       #####
#####                                                                                                                       #####
#####                                                                                                                       #####
#####                                                                                                                       #####
#####                                                                                                                       #####
#####                                                                                                                       #####
#####                                                                                                                       #####
#####                                                                                                                       #####
#####                                                         #####                                                         #####
#####                                                         #####                                                         #####
#####                   #########################             #####             #########################                   #####
#####                   #########################             #####             #########################                   #####
#####                   #########################             #####             #########################                   #####
#####                   #########################             #####             #########################                   #####
#####                   #########################             #####             #########################                   #####
#####                                                         #####                                                         #####
#####                                                         #####                                                         #####
#####                                                         #####                                                         #####
#####                                                         #####                                                         #####
#####                                                         #####                                                         #####
#####                                                         #####                                                         #####
#####                                                         #####                                                         #####
#####                                                         #####                                                         #####
#####                                                         #####                                                         #####
#####                                                         #####                                                         #####
#####                                                         #####                                                         #####
#####                                                         #####                                                         #####
#####                                                         #####                                                         #####
#####                                                         #####                                                         #####
#####                                                         #####                                                         #####
#####                                                         #####                                                         #####
#####                                                         #####                                                         #####
#####                                                         #####                                                         #####
#####                                                         #####                                                         #####
#####                                                         #####                                                         #####
#####                                                         #####                                                         #####
#################################################################################################################################
#################################################################################################################################
#################################################################################################################################
#################################################################################################################################
#################################################################################################################################